1111111111111111
1000000000010001
1000000000111001
11000000001 1001
1000000000111001
1000000000000011
100000110000001
100000110000001
100000000000001
100000P00000001
111111111111111
