111111111111111111111111
100000000000000000000001
100P00000000000011000001
100000000000000011000001
100000000000000000000001
100000000000000000000001
100000000000000000000001
100000000000000000000001
100000000000000000000001
100000000000000000000001
100000000000000000110001
100000000000000000110001
100000000000000000000001
111111111111111111111111
